00000000122
000000a0022
00000100022
00000100022
00000100022
00000100022
00000000022
000b0000022
00000000022
00000000022
00000000022
00000004022
00000001122
00000011022
00004110022
00001100022
00000000022
90003333322
00000000022
00000000022
00b00000022
00000000022
00000000022
00000000622
00000000022
00000000322
00000003322
00000033322
00000000000
00000000000
00000033322
00000003322
00000000322
00000000a22
00000000022
00000000422
00000000022
000b00a0022
00000000022
0000p000622
00000000022
00000000322
00000003322
00000033322
00000333322
00003333322
00033333322
00000000022
00000000022
00000b00000
00000000000
00000000000
00000000222
00000000022
00000000022
00000000022
00000000022
00000000022
00000000022
00000000022
000000a0022
00000000022
00000000022
00000000522
00000000222
00000002222
00000000222
00000000022
000000dcc22
0000dcecc22
0000dceg022
0000dcefc22
000000dcc22
00000000022
000000a0022
00000000022
00000000022
00000000022
00000000022
00000000022
00000000022
