00000000022
00000000022
00000000022
00000000022
00000000022
0000000a022
00000000022
0b000000022
00000000022
00000700622
00000700022
00000000022
00000000022
000000a0022
00000000022
00000000022
00b00000022
00000000022
00000000322
00000003322
00000033322
00000000000
00000000000
00000000000
00000033322
00000003322
00000000322
00000000022
00000006022
00000000022
00000000022
00000010022
00004010022
00000010022
00004010022
00000010022
b0000000022
00000000022
00000000022
00000000022
00000000022
00000000022
00000000022
00000000422
00000000022
00000000422
00000000022
0b000000422
00000000022
00000000022
00000000022
00000000022
00000000022
00000000022
00000000022
00000000022
00000000022
00000000022
00000000022
00000000022
00000000022
00000000022
00000000022
000b00dcc22
00dcfcecc22
00dccceg022
00dcccefc22
000000dcc22
00000000022
00000000022
00000000022
00000000022
