00000000222
00000000422
00000000022
00000000022
00000000022
00005010022
00000410022
00000010022
00000010022
00000000022
00000000022
00000000022
00000001122
00000011022
00000110022
00001100022
00000000022
00000000022
00000100000
00000000000
00000000100
00000000100
00000000000
00000110000
00000110000
00000000000
00000000022
00000000000
00000000000
00000000022
00000000022
00000010022
00000010022
00000010022
00000010022
00000000022
00000000022
00000000022
00000000022
00000000022
00000000022
00000000022
00000000022
00000000000
00000000000
00000010000
00000000000
00000000000
00000000000
00000010000
00000000000
00000000000
00000000010
00000000000
00000000100
00000000000
00000100000
00000000000
00010000000
00000000000
00000000000
00000000000
00000000000
00000000100
00000000022
00000000022
00000000022
00000000022
00000000022
00000000022
00000000022
00000000022
00000000022
00000000022
00000000022
00000000022
00000000022
00000020022
00000020022
00000020022
00000020022
00000000022
00000000022
00000000022
00000000022
00000000022
00000000022
00000000022
00000000022
00000000022
00000000022
00000000022
00000000022
00000000022
00000000022
00000000022
00000000022
00000000022
00000000000
00000000000
00000000000
00000000000
00000000010
00000000000
00000000000
00000000000
00000000000
00000000010
00000000000
00000000000
00000000000
00000000000
00000000010
00000000000
00000000000
00000000000
00000000000
00000000010
00000000010
00000000010
00000000322
00000003322
00000033322
00000333322
00003333322
00033333322
