00000000022
00000000022
00000000022
00000000022
00000000022
00000010022
00000010022
00000010022
00000010022
00000000022
00000000022
00000000022
00000000022
00000000022
00000000022
00000000022
00000000022
00000000022
00000000022
00000000022
00000000022
00000000022
00000000022
00000110022
00000110022
00000000022
00000000022
00000000022
00000000022
00000000022
00000000022
00000010022
00000010022
00000010022
00000010022
00000000022
00000000022
00000000022
00000000022
00000000022
00000000022
00000000022
00000000022
00000000022
00000000022
00000000022
00000000022
00000000022
00000000022
00000000022
00000000022
00000000022
00000000022
00000000022
00000000022
00000000022
00000000022
00000020022
00000020022
00000020022
00000020022
00000000022
00000000022
00000000022
00000000022
00000000022
00000000022
00000000022
00000000022
00000000022
00000000022
00000000022
00000000022
00000000022
00000000022
00000000022
00000000022
00000000022