00000000222
00000000022
00000100022
00000000022
00000000022
00000000022
00009000022
00000000022
00008000022
00000000022
00000000022
00000000022
00000001122
00000011022
00000110022
00001100022
00000000022
00000000022
00000000022
000b00dcc22
0000dcecc22
0000dceg022
0000dcefc22
000000dcc22
00000000022
00000000022
00000000022
00000000022
