00000000022
00000000022
00000000022
00000000022
00000000022
00000020022
00000220022
00000220022
00000020022
00000000022
00000000022
00000000022
00000000022
00000000022
00000000022
00000020022
00000020022
00000020022
00000000022
00000000022
00000000022
00000000022
00000000022
00000000022
00000000022
00000000022